6 6 6 6 6 6 6 6 6 6 6 6 6 6 6 6 6 6 6 6 6 6 6 6 6 6 6 6 6 6 6 6 6 6 6 6 6 6 6 6 6 6 6 6 6 6 6 6 6 6 6 6 6 6 6 6 6 6 6 6 6 6 6 6 6 6 6 6 6 6 6 6 6 6 6 6 6 6 6 6 6 6 6 6 6 6 6 6 6 6 6 6 6 6 6 6 6 6 6 6 6 6 6 6 6 6 6 6 6 6 6 6 6 6 6 6 6 6 6 6 6 6 6 6 6 6 6 6 6 6 6 6 6 6 6 6 6 6 6 6 6 6 6 6 6 6 6 6 6 6 6 6 6 6 6 6 6 6 6 6 6 14 13 13 13 13 13 13 13 13 13 13 13 13 13 13 13
6 6 6 6 6 6 6 6 6 6 6 6 6 6 6 6 6 6 6 6 6 6 6 6 6 6 6 6 6 6 6 6 6 6 6 6 6 6 6 6 6 6 6 6 6 6 6 6 6 6 6 6 6 6 6 6 6 6 6 6 6 6 6 6 6 6 6 6 6 6 6 6 6 6 6 6 6 6 6 6 6 6 6 6 6 6 6 6 6 6 6 6 6 6 6 6 6 6 6 6 6 6 6 6 6 6 6 6 6 6 6 6 6 6 6 6 6 6 6 6 6 6 6 6 6 6 6 6 6 6 6 6 6 6 6 6 6 6 6 6 6 6 6 6 6 6 6 6 6 6 6 6 6 6 6 6 6 6 6 6 6 6 14 13 13 13 13 13 13 13 13 13 13 13 13 13 13
3 7 7 7 3 4 3 4 5 3 4 5 8 7 5 4 3 8 3 7 7 7 3 4 3 4 5 3 4 5 8 7 5 4 3 8 3 7 7 7 3 4 3 4 5 3 4 5 8 7 5 4 3 8 3 7 7 7 3 4 3 4 5 3 4 5 8 7 5 4 3 8 3 7 7 7 3 4 3 4 5 3 4 5 8 7 5 4 3 8 3 7 7 7 3 4 3 4 5 3 4 5 8 7 5 4 3 8 3 7 7 7 3 4 3 4 5 3 4 5 8 7 5 4 3 8 5 3 4 5 8 7 5 4 3 8 3 7 7 7 3 4 3 4 4 5 3 4 5 8 7 5 4 3 8 3 7 7 7 11 6 6 6 14 13 13 13 13 13 13 13 13 13 13 13 13 13
0 1 2 0 1 2 0 1 0 1 0 1 2 0 1 0 1 2 0 1 2 0 1 2 0 1 0 1 0 1 2 0 1 0 1 2 0 1 2 0 1 2 0 1 0 1 0 1 2 0 1 0 1 2 0 1 2 0 1 2 0 1 0 1 0 1 2 0 1 0 1 2 0 1 2 0 1 2 0 1 0 1 0 1 2 0 1 0 1 2 0 1 2 0 1 2 0 1 0 1 0 1 2 0 1 0 1 2 0 1 2 0 1 2 0 1 0 1 0 1 2 0 1 0 1 2 2 0 1 2 0 1 0 1 0 1 2 0 1 0 1 2 1 0 1 0 1 2 0 1 2 0 1 2 0 1 0 1 0 1 5 12 6 16 13 13 13 13 13 13 13 13 13 13 13 13 13
1 2 0 1 2 0 1 0 1 0 1 2 0 1 0 1 2 1 1 2 0 1 2 0 1 0 1 0 1 2 0 1 0 1 2 1 1 2 0 1 2 0 1 0 1 0 1 2 0 1 0 1 2 1 1 2 0 1 2 0 1 0 1 0 1 2 0 1 0 1 2 1 1 2 0 1 2 0 1 0 1 0 1 2 0 1 0 1 2 1 1 2 0 1 2 0 1 0 1 0 1 2 0 1 0 1 2 1 1 2 0 1 2 0 1 0 1 0 1 2 0 1 0 1 2 1 1 0 1 0 1 2 0 1 0 1 2 0 1 2 0 1 2 2 0 1 0 1 0 1 2 0 1 0 1 2 0 1 2 0 1 2 12 6 14 13 13 13 13 13 13 13 13 13 13 13 13
2 0 1 2 0 1 0 1 0 1 2 0 1 0 1 2 1 0 2 0 1 2 0 1 0 1 0 1 2 0 1 0 1 2 1 0 2 0 1 2 0 1 0 1 0 1 2 0 1 0 1 2 1 0 2 0 1 2 0 1 0 1 0 1 2 0 1 0 1 2 1 0 2 0 1 2 0 1 0 1 0 1 2 0 1 0 1 2 1 0 2 0 1 2 0 1 0 1 0 1 2 0 1 0 1 2 1 0 2 0 1 2 0 1 0 1 0 1 2 0 1 0 1 2 1 0 0 1 2 0 1 0 1 2 1 0 2 0 1 2 0 2 0 1 1 2 0 1 0 1 0 1 2 0 1 0 1 2 1 0 2 1 0 9 16 13 13 13 13 13 13 13 13 13 13 13 13
0 1 2 0 1 2 0 1 0 1 0 1 2 0 1 0 1 2 0 1 2 0 1 2 0 1 0 1 0 1 2 0 1 0 1 2 0 1 2 0 1 2 0 1 0 1 0 1 2 0 1 0 1 2 0 1 2 0 1 2 0 1 0 1 0 1 2 0 1 0 1 2 0 1 2 0 1 2 0 1 0 1 0 1 2 0 1 0 1 2 0 1 2 0 1 2 0 1 0 1 0 1 2 0 1 0 1 2 0 1 2 0 1 2 0 1 0 1 0 1 2 0 1 0 1 2 0 1 2 0 1 2 0 1 2 0 1 0 1 0 1 2 2 1 2 0 1 2 0 1 0 1 0 1 2 0 1 0 1 2 1 0 10 6 15 13 13 13 13 13 13 13 13 13 13 13 13
1 2 0 1 2 0 1 0 1 0 1 2 0 1 0 1 2 0 1 2 0 1 2 0 1 0 1 0 1 2 0 1 0 1 2 0 1 2 0 1 2 0 1 0 1 0 1 2 0 1 0 1 2 0 1 2 0 1 2 0 1 0 1 0 1 2 0 1 0 1 2 0 1 2 0 1 2 0 1 0 1 0 1 2 0 1 0 1 2 0 1 2 0 1 2 0 1 0 1 0 1 2 0 1 0 1 2 0 1 2 0 1 2 0 1 0 1 0 1 2 0 1 0 1 2 0 2 0 1 0 1 0 1 2 0 1 0 1 2 0 1 2 0 1 1 0 1 2 1 0 2 0 1 2 0 1 0 1 0 1 2 0 10 16 13 13 13 13 13 13 13 13 13 13 13 13 13
2 0 1 2 0 1 0 1 0 1 2 0 1 0 1 2 1 0 2 0 1 2 0 1 0 1 0 1 2 0 1 0 1 2 1 0 2 0 1 2 0 1 0 1 0 1 2 0 1 0 1 2 1 0 2 0 1 2 0 1 0 1 0 1 2 0 1 0 1 2 1 0 2 0 1 2 0 1 0 1 0 1 2 0 1 0 1 2 1 0 2 0 1 2 0 1 0 1 0 1 2 0 1 0 1 2 1 0 2 0 1 2 0 1 0 1 0 1 2 0 1 0 1 2 1 0 1 0 2 0 1 2 0 1 0 1 0 1 2 0 1 0 1 2 2 1 1 2 0 1 2 0 1 0 1 0 1 2 0 1 0 1 2 9 14 13 13 13 13 13 13 13 13 13 13 13 13
2 0 1 2 0 1 0 1 0 1 2 0 1 0 1 2 1 0 2 0 1 2 0 1 0 1 0 1 2 0 1 0 1 2 1 0 2 0 1 2 0 1 0 1 0 1 2 0 1 0 1 2 1 0 2 0 1 2 0 1 0 1 0 1 2 0 1 0 1 2 1 0 2 0 1 2 0 1 0 1 0 1 2 0 1 0 1 2 1 0 2 0 1 2 0 1 0 1 0 1 2 0 1 0 1 2 1 0 2 0 1 2 0 1 0 1 0 1 2 0 1 0 1 2 1 0 2 0 1 2 0 1 0 1 0 1 2 0 1 0 1 2 0 0 0 1 0 1 0 1 2 0 1 0 1 2 0 1 2 0 1 2 10 6 6 14 13 13 13 13 13 13 13 13 13 13 13
0 1 2 0 1 2 0 1 0 1 0 1 2 0 1 0 1 2 0 1 2 0 1 2 0 1 0 1 0 1 2 0 1 0 1 2 0 1 2 0 1 2 0 1 0 1 0 1 2 0 1 0 1 2 0 1 2 0 1 2 0 1 0 1 0 1 2 0 1 0 1 2 0 1 2 0 1 2 0 1 0 1 0 1 2 0 1 0 1 2 0 1 2 0 1 2 0 1 0 1 0 1 2 0 1 0 1 2 0 1 2 0 1 2 0 1 0 1 0 1 2 0 1 0 1 2 1 2 1 0 2 0 1 2 0 1 0 1 0 1 2 0 1 0 2 0 1 0 1 0 1 2 0 1 0 1 2 0 1 2 2 2 0 12 6 6 14 13 13 13 13 13 13 13 13 13 13
1 2 0 1 2 0 1 0 1 0 1 2 0 1 0 1 2 0 1 2 0 1 2 0 1 0 1 0 1 2 0 1 0 1 2 0 1 2 0 1 2 0 1 0 1 0 1 2 0 1 0 1 2 0 1 2 0 1 2 0 1 0 1 0 1 2 0 1 0 1 2 0 1 2 0 1 2 0 1 0 1 0 1 2 0 1 0 1 2 0 1 2 0 1 2 0 1 0 1 0 1 2 0 1 0 1 2 0 1 2 0 1 2 0 1 0 1 0 1 2 0 1 0 1 2 0 1 0 1 2 1 0 2 0 1 2 0 1 0 1 0 2 1 0 1 0 1 0 1 2 0 1 0 1 2 1 1 2 0 1 2 0 1 2 12 6 6 14 13 13 13 13 13 13 13 13 13